11111111111111111111111111111111111
10000000000000000000010000001110001
10000000000000000000010000001110001
10000000000000000000000000001110001
10000000000000000000000000000000001
10000000000000000000000000000000001
10000000000000000000000000000000001
10000000000011111110000000000000001
10000000000011111110000000000000001
10000000000011111110000000000000001
10000000000000000000000000000000001
10000000000000000000000000000000001
10000000000000000000000000000000001
11111111111111111111111111111111111