111111111111111111111111111111111111
100000000000000000000100000011100001
100000000000000000000100000011100001
100000000000000000000000000011100001
100000000000000000000000000000000001
100000000000000000000000000000000001
100000000000000000000000000000000001
100000000000111111100000000000000001
100000000000111111100000000000000001
100000000000111111100000000000000001
100000000000000000000000000000000001
100000000000000000000000000000000001
100000000000000000000000000000000001
111111111111111111111111111111111111