1111111111
1000000001
1000001111
1000001111
1000000001
1000000001
1111100001
1111100001
1000000001
1111111111