NO ./Ext/rg.xpm
SO ./Ext/rg.xpm
WE ./Ext/rg.xpm
EA ./Ext/rg.xpm

C   19,19,52
F   46,49,52

111111111111111111111111111111111111
1N0000000000000000000100000011100001
100000111000000000001000000111000001
100000111000000000000000000011100001
100000000111000000000000010000000001
100000000111000000100000000000000001
100000000000000000000000000000000001
100000000000000000000000100100100101
100000000000001111100000000000000001
100000000000111111100000000000000001
100000000000000000000000000000000001
100000000000000000000000001110000001
100000000000000000000000001110000001
111111111111111111111111111111111111