NO ./Ext/lf.xpm
SO ./Ext/lf.xpm
WE ./Ext/lf.xpm
EA ./Ext/lf.xpm


C   19,19,52
F   46,49,52 

                                    1111111111111111111111111111111111111111111
                                    1000000000000000000000111
                                    100000000000000000000011111111111111
                                    10000000000100000000001
                                    10000000000010000000001
                                    1N000000000000000000001
                                    11111111111111111111111
