NO ./Ext/lf.xpm
SO ./Ext/lf.xpm
WE ./Ext/lf.xpm
EA ./Ext/lf.xpm


C   19,19,52
F   46,49,52 

111111111111111111111111111111111111111111111111111111111111111111111111111111111111
1000001000000010000000000000000000000000000000000000000000000000000000000000000000001
10000111111111111111111111111111111111111111111111111111111111111111111111111111111111
10S000110000000000000100010000000000000000000000000000000000000000000000000000000001
100000100000000000000000010000000000000000000000000000000000000000000000000000000001
100000110000000000000100010000000000000000000000000000000000000000000000000000000001
11101111111011111111110001111111111111111111111111111111111111111111111111111111111
110000110000001      10001000000000000000000000000000000000000000000000000000000001
100000010000001      10001000000000000000000000000000000000000000000000000000000001
100000010000001      10001000000000000000000000000000000000000000000000000000000001
10000000000000111111111011111111111000000000000000000000000000000000000000000000001
10000001000000100000000000000000001000000000000000000000000000000000000000000000001
1000000100000010000000000000000000111111111111111111111111111111111111111111111111
1100001100000010011000000000001100100011111111111111111111111111111111111111111111
11111111111111100100000000000001001000100000000000000000000000000000000000000000011
              1000000000000000000010001000000000000000000000000000000000000000000001
              1000000000000000000010001000000000000000000000000000000000000000000001
              1000000000000000000000001000000000000000000000000000000000000000000001
              1000000000000000000010001000000000000000000000000000000000000000000001
              1000000000000000000010001000000000000000000000000000000000000000000001
              1001000000000000010010001000000000000000000000000000000000000000000001
              1001100000000000110010001000000000000000000000000000000000000000000001
              1000000000000000000010001000000000000000000000000000000000000000000001
              1000000000000000000010001000000000000000000000000000000000000000000001
              1111111111111111111110001000000000000000000000000000000000000000000001
                                  1000111111111111111111111111111111111111111111111
                                  1000100000000000000000000000000000000000000001
                                  1000010000000000000000000000000000000000000001
                                  1000010000000000000000000000000000000000000001
                                  100011111011111111100111111111111111111111111
                                  1000000010001    11101111111111111111
                                  1000000000001    100000000001
                                  1000000010001    100000000001
                                  1111011110001    100000000001
                                    10001 10101    100000000001
                                    10001110111    100000000001
                                    10000000001    100000000001
                                    11111100001    111111011111
                                         110001        10001
                                          10001        10001
                                           10001       10101
                                            10001      11111
                                             10001
                                              10001
                                               10001
                                                10001111111111111111111111111111111111111
                                                10000010001000001000000010000000001010001
                                                11101010101011101011101110111011101011101
                                                10001000101010101000100000101010000000001
                                                10101110111110101111111010101110111111111
                                                10101010100000000010000010100010100010001
                                                10111011111111111010111110101111111010101
                                                10101010001000001010000010000010100000101
                                                10101010101110111011101011111110111111101
                                                10000010101000001000001010100010001000001
                                                10101010111111101110111110101111101011101
                                                10101000000010000010000000000010000000101
                                                11101010111110111010101011101110111111111
                                                10101010000000100000101000100000100000001
                                                10101110111010111010101111111110101111101
                                                1000100000101000101010100000001000001011
                                                10111011101110101011111011101110111010101
                                                10100010001010101000001000100010001010101
                                                10111010101011101111101011101111101010101
                                                10100010101000101000100000100010101010001
                                                10111010101110101110101011111110111011101
                                                10101010100000101000001000100010001010101
                                                10101110101111111110101111101110101010101
                                                10001000100010000000100010000010101010101
                                                10101011101010101111111110111110111010111
                                                10101010001010100000000000100000100010001
                                                101010111110111111111111101011111111111011
                                                10101000101000001000001000101000001000001
                                                11101110101111111010111110101010111011111
                                                10001000000010000010100010000010100000001
                                                10111111111011101010101111111110111111101
                                                10100000001000001010000010000010001010001
                                                11101010111110111011111010111111101010101
                                                10001010100000100000001010100000100010101
                                                10101110101011101111101110101110111010111
                                                10101000101010000010000010001000000010001
                                                10101011101010111011111111111010111010101
                                                10101000001010101000000000001010001000101
                                                1010111111101010101110111110101110111110111111111
                                                1010000010001000101000000010101000000010000000001
                                                1111111111111111111111111111111111111111100000001
                                                                        1000000011111111111111111
                                                                        100000001
                                                                        100000001
                                                                        100000001
                                                                        111111111