NO ./Ext/no.xpm
SO ./Ext/so.xpm
WE ./Ext/we.xpm
EA ./Ext/ea.xpm

C   19,19,52
F   46,49,52

  1111111111111111111111111111111111111
  11111S0000000000111101111111111100001
  1000000000000000101000000000000000001
  1000100000000000111001100000000000001
  1000100000000000000001000000000000001
  1000111111011111111111000000000000001
  1000000010001    11100001111111111111
  1000000000001    100000000001
  1000000010001    10000000000111111111
  1111011110001    10000000000000000001
    10001 10101    10000000000100000001
    10001110111    10000000000100000001
    10000000001    10000000000100000001
    11111100001    11111101111101111111
         110001        1000100000001
     1111000111       11000100000001
   11000000111       11001111110001
   100111111     111110000000000011
   1001          100000011111111111
   1001          10000000000000001
   1001          11111111111111001
   1001          10000000000000001
   1001          10011111111111111
   1001          1001
   1001          1001111
   1001          1000001
   1001          1111001
   1001          1111001
   1001          111100111111111111111111111
   1001          111100000000000000011111111
   1001          11111111111111111000000000111111111111111
   1001          10000010001000001000000010000000001010001
   1001          11101010101011101011101110111011101011101
   1001          10001000100010101000100000101010000000001
   1001          10101110111110101111111010101110111111111
   1001          10101010100000000010000010100010100010001
   1001          10111011111111111010111110101111111010101
   1001          10101010001000001010000000000010100000101
   1001          10101010101110111011101011111110111111101
   1001          10000010101000001000001010100010001000001
   1001          10101010111111101110111110101111101011101
   1001          10101000000010000010000000000010000000101
   1001          11101010111110111010101011101110111111111
   1001          10101010000000100000101000100000100000001
   1001          10101110111010111010101111111110101111101
   1001          10001000001010001010101000000010000010111
   1001          10111011101110101011111011101110111010101
   1001          10100010001010101000001000100010001010101
   1001          10111010101011101111101011101111101010101
   1001          10100010101000101000100000100010101010001
   1001          10111010101110101110101011111110111011101
   1001          10101010100000101000001000100010001010101
   1001          10101110101111111110101111101110101010101
   1001          10001000100010000000100010000010101010101
   1001          10101011101010101111111110111110111010111
   1001          10101010001010100000000000100000100010001
   1001          10101011111011111111111110101111111111101
   1001          10101000101000001000001000101000001000001
   1001          11101110101111111010111110101010111011111
   1001          10001000000010000010100010000010100000001
   1001          10111111111011101010101111111110111111101
   1001          10100000001000001010000010000010001010001
   1001          11101010111110111011111010111111101010101
   1001          10001010100000100000001010100000100010101
   1001          10101110101011101111101110101110111010111
   1001          10101000101010000010000010001000000010001
   1001          10101011101010111011111111111010111010101
   1001          10101000001010101000000000001010001000101
   1001          1010111111101010101110111110101110111110111111111
   1001          1010000010001000101000000010101000000010000000001
   1001          1111111111111111111111111111111111111111100000001
   10011                                                111111001
   10011111111111111111111111111111111111111111111111111100000001
   10000000000000000000000000000000000000000000000000000000011111
   11111111111111111111111111111111111111111111111111111110000001
   11111111111111111111111111111111111111111111111111111111111111