NO ./Ext/up.xpm
SO ./Ext/dn.xpm
WE ./Ext/lf.xpm
EA ./Ext/rg.xpm

C   0,0,0
F   255,15,255

111111111111111111111111111111111111
100000000000000000000100000011100001
100000111000000000000100000011100001
100000111000000000000000000011100001
100000000111000000000000000000000001
100000000111000000000000000000000001
100000000000000000000000000000000001
100000000000000000000000100100100101
100000000000001111100000000000000001
100000000000111111100000000000000001
100000000000000000000000000000000001
100000000000000000000000001110000001
100000000000000000000000001110000001
111111111111111111111111111111111111