NO ./Ext/up.xpm
SO ./Ext/dn.xpm
WE ./Ext/lf.xpm
EA ./Ext/rg.xpm

C   19,19,52
F   46,49,52

111111111111111111111111111111111111
100000000000000000000100000011100001
100000111000000000000100000011100001
100000111000000000000000000011100001
100000000111000000000000000000000001
100000000111000000100000000000000001
100000000000000000000000000000000001
100000000000000000000000100100100101
100000000000001111100000000000000001
100000000000111111100000000000000001
100000000000000000000000000000000001
100000000000000000000000001110000001
100000000000000000000000001110000001
111111111111111111111111111111111111