NO ./Ext/lf.xpm
SO ./Ext/lf.xpm
WE ./Ext/lf.xpm
EA ./Ext/lf.xpm


C   19,19,52
F   46,49,52 

11111
10001
10001
10001
10001
10001
10001
10001
10001
10001
10001
10N01
10001
10001
10001
10001
10001
10001
10001
10001
10001
10001
10001
10001
10001
10001
10001
10001
10001
11111
