NO ./Ext/lf.xpm
SO ./Ext/lf.xpm
WE ./Ext/lf.xpm
EA ./Ext/lf.xpm


CC   19,19,52
F   46,49,52

111      11111111111111111111111111
1101     100000000000110000000N00001
111     100100000111000000100000001
       100100000000000000000000001
111111111011000011110000000000001
100000000011000001110111111111111
11110111111111011100000010001
11110111111111011101010010001
11000000110101011100000000001
10001000000000001100000010001
100000000000000011010100100001
1100000111010101111101111000111
11110111 1110101 1011110100001
11111111 1111111 111111111111
