NO ./Ext/lf.xpm
SO ./Ext/lf.xpm
WE ./Ext/lf.xpm
EA ./Ext/lf.xpm


C   19,19,52
F   46,49,52 

1111111111111111111111111111111111111111111111111111111111111111111111111111111111111111111
1N00001000100000100000001000000000101000110000010000000000000100000000001000000000000000001
1110101010101110101110111011101110101110111111111111111111010111111110111011101110111111111
1000100010101010100010000010101000000000110000010000000000000100000000001000000000000000001
1010111011111010111111101010111011111111101111111101111111110111111110111111101011111111111
1010101010000000001000001010001010001000100000010000000000010000000000001000000000000000001
1011101111111111101011111010111111101010111111110111111110111111111111111010111111111111111
1010101000100000101000001000001010000010000000010000000000010000000000001000000000000000001
1010101010111011101110101111111011111111111111111111111111111111111111111111111111111111111
1000001010100000100000101010001000100000100000010000000000010000000000001000000000000000001
1010101011111110111011111010111110101110111111110111111110111111110111111110111111111111111
1010100000001000001000000000001000000010000000010000000000010000000000001000000000000000001
1110101011111011101010101110111011111111101111111101111111110111111110111111110111111111111
1010101000000010000010100010000010001000100000010000000000010000000000001000000000000000001
1010111011101011101010111111111010111111101111111101111111110111111110111111101011111111111
1000100000101000101010100000001000001010000010001000000000101000000000010000000000000000001
1011101110111010101111101110111011101010111111110111111110111111110111111110111111111111111
1010001000101010100000100010001000101010100000010100000000101000000000010000000000000000001
1011101010101110111110101110111110101010111111110111111110111111110111111110111111111111111
1010001010100010100010000010001010101000100000010100000000101000000000010000000000000000001
1011101010111010111010101111111011101111101111111101111111110111111110111111101011111111111
1010101010000010100000100010001000101010100000010100000000101000000000010000000000000000001
1010111010111111111010111110111010101010101111110111111110111111110111111110111111111111111
1000100010001000000010001000001010101010100000010100000000101000000000010000000000000000001
1010101110101010111111111011111011101011101111110111111110111111110111111110111111111111111
1010101000101010000000000010000010001000100000010100000000101000000000010000000000000000001
1010101111101111111111111010111111111110111111110111111110111111110111111110111111111111111
1010100010100000100000100010100000100000100000010100000000101000000000010000000000000000001
1110111010111111101011111010101011101111101111111101111111110111111110111111110111111111111
1000100000001000001010001000001010000000000000010000000000010000000000001000000000000000001
1011111111101110101010111111111011111011111111110111111110111111110111111110111111111111111
1010000000100000101000001000001000000010000000010000000000010000000000001000000000000000001
1110101011111011101111101011111110101010111111110101111110111111110111111110111111111111111
1000101010000010000000101010000010001010100000010100000000101000000000010000000000000000001
1010111010101110111110111010111011010110111111110111111110111111110111111110111111111111111
1010100010101000001000001000100000001000000000010000000000010000000000001000000000000000001
1010101110101011101111111111101110101110101111110111111110111111110111111110111111111111111
1010100000101010100000000000101000100010001000010100000000101000000000010000000000000000001
1010111111101010101110111110101111110111110111110111111110111111110111111110111111111111111
1010000010001000101000000010101000000010000010000100000000101000000000010000000000000000001
1111111111111111111111111111111111111111111111111100000000100000000000010000000000000000001
                                    100000001111111111111000111111111111111111111111111111
                                    1000000000000000000000111
                                    1000000011111111111111
                                    100000001
                                    111111111
